8 8
GGGGGGGG
GBBBBBBG
GGGGGGGG
GWGGGGBG
GBGGGGWG
GGGGGGGG
GWWWWWWG
GGGGGGGG
P      K
        
K      K
        
K      K
        
 BBBBBB 
        